alias ..='cd ..'
alias cd..='cd ..'
alias ...='cd ../../../'
alias ....='cd ../../../../'
alias .....='cd ../../../../'
alias .4='cd ../../../../'
alias .5='cd ../../../../..'
alias sf=screenfecth
alias cm=coinmon
alias c=clear
alias ll='ls -al'
alias la='ls -A' 
alias l='ls -alFtr' 
alias lsd='ls -d .*' 
alias h='history | tail'
alias hg='history | grep'
alias p=pwd
alias x=exit
alias awk=gawk
alias {ack,ak}=ack-grep
alias l.='ls -d .*'
alias grep='grep --color=auto'
alias egrep='egrep --color=auto'
alias fgrep='fgrep --color=auto'
alias bc='bc -l'
alias sha1='openssl sha1'
alias mkdir='mkdir -pv'
alias diff=colordiff
alias mount='mount |column -t'
alias h='history'
alias j='jobs -l'
alias path='echo -e ${PATH//:/\\n}'
alias now='date +"%T"'
alias nowtime=now
alias nowdate='date +"%d-%m-%Y"'
alias vi=vim
alias svi='sudo vi'
alias vis='vim "+set si"'
alias edit=vim
alias ping='ping -c 5'
alias fastping='ping -c 100 -s.2'
alias ports='netstat -tulanp'
alias ipt='sudo /sbin/iptables'
alias iptlist='sudo /sbin/iptables -L -n -v --line-numbers'
alias iptlistin='sudo /sbin/iptables -L INPUT -n -v --line-numbers'
alias iptlistout='sudo /sbin/iptables -L OUTPUT -n -v --line-numbers'
alias iptlistfw='sudo /sbin/iptables -L FORWARD -n -v --line-numbers'
alias firewall=iptlist
alias header='curl -I'
alias headerc='curl -I --compress'
alias rm='rm -i'
alias mv='mv -i'
alias cp='cp -i'
alias ln='ln -i'
alias root='sudo -i'
alias su='sudo -i'
alias sudo='sudo '
alias edit_profile='open -e ~/.profile'
alias edit_hosts='edit /etc/hosts'
alias edit_httpd='edit /etc/apache2/httpd.conf'
alias edit_php='edit /etc/php.ini'
alias edit_vhosts='edit /etc/apache2/extra/httpd-vhosts.conf'
alias goto_web='cd ~/Sites'
alias killDS='find . -name *.DS_Store -type f -delete'
alias reboot='sudo /sbin/reboot'
alias poweroff='sudo /sbin/poweroff'
alias halt='sudo /sbin/halt'
alias shutdown='sudo /sbin/shutdown'
alias reload_profile='. ~/.profile'
alias poweroff='sudo /sbin/shutdown -h now'
alias dnstop='dnstop -l 5  eth1'
alias vnstat='vnstat -i eth1'
alias iftop='iftop -i eth1'
alias tcpdump='tcpdump -i eth1'
alias ethtool='ethtool eth1'
alias iwconfig='iwconfig wlan0'
alias meminfo=vm_stat
alias psmem='ps aux | sort -nr -k 4'
alias psmem10='ps aux | sort -nr -k 4 | head -10'
alias pscpu='ps aux | sort -nr -k 3'
alias pscpu10='ps aux | sort -nr -k 3 | head -10'
alias cpuinfo='sysctl -n machdep.cpu.brand_string'
alias gpumeminfo=glxinfo
alias cpudetail='./scripts/cpudetail.sh'
alias wget='wget -c'
# osx specifics aliases
alias brewup="brew update;brew upgrade --ignore-pinned;brew cask upgrade;brew cleanup;brew doctor"
alias killdash='defaults write com.apple.dashboard mcx-disabled -boolean YES; killall Dock'
alias scfrmt='defaults write com.apple.screencapture type JPG'
alias showhid='defaults write com.apple.finder AppleShowAllFiles TRUE'
alias dragwidg='defaults write com.apple.dashboard devmode YES'
alias ssh_state='sudo systemsetup -getremotelogin'
alias ssh_on='sudo systemsetup -f -setremotelogin on'
alias ssh_off='sudo systemsetup -f -setremotelogin off'
alias ip="curl -s http://checkip.dyndns.org/ | sed 's/[a-zA-Z<>/ :]//g'"
alias localip='ipconfig getifaddr en1 && ipconfig getifaddr en0'
alias wifi='airport -I'
alias move=mv
alias copy=cp
alias ren=mv
alias del=rm
alias dir=ls
alias pload='source ~/.zshrc'
alias zload=pload
alias kto='sudo python3 ~/kickthemout/kickthemout.py'
alias wifipwd='security find-generic-password -wa <yourSSID>'
